ARGUMENTS	VALUES	GROUPS
data	batch_1.vcf	fct.call.args
strata	spec_tbl_df	fct.call.args
filename	NULL	fct.call.args
parallel.core	7	fct.call.args
verbose	FALSE	fct.call.args
filter.common.markers	TRUE	fct.call...
filter.monomorphic	TRUE	fct.call...
gt	TRUE	fct.call...
gt.bin	TRUE	fct.call...
gt.vcf	TRUE	fct.call...
gt.vcf.nuc	TRUE	fct.call...
internal	TRUE	fct.call...
path.folder	01_radiator_genomic_converter_20190829@1553	fct.call...
tidy.check	FALSE	fct.call...
vcf.metadata	TRUE	fct.call...
vcf.stats	TRUE	fct.call...
whitelist.markers	NULL	fct.call...
blacklist.id	NULL	default...
filter.coverage	NULL	default...
filter.genotyping	NULL	default...
filter.individuals.coverage.total	NULL	default...
filter.individuals.missing	NULL	default...
filter.long.ld	NULL	default...
filter.mac	NULL	default...
filter.short.ld	NULL	default...
filter.snp.number	NULL	default...
filter.snp.position.read	NULL	default...
filter.strands	blacklist	default...
ld.method	r2	default...
long.ld.missing	FALSE	default...
parameters	NULL	default...
random.seed	NULL	default...
ref.calibration	FALSE	default...
tidy.vcf	NULL	default...
